[alias]
        f = fetch
        g = gui
        c = commit
	co = checkout
	dt = difftool
	mt = mergetool
	praise = blame
	ff = merge --ff-only
	st = status
	sync = !git pull && git push
	unstage = reset HEAD --
	last = log -1 HEAD
	graf = log --oneline --decorate --graph --all
	br = branch -v
        brall = branch -avv
        brd = branch -d
	brdo = push origin --delete 
    	please = push --force-with-lease
	commend = commit --amend --no-edit
	it = !git init && git commit -m “root” --allow-empty
	stsh = stash --keep-index
	staash = stash --include-untracked
	staaash = stash --all
	stt = status --short --branch
	merc = merge --no-ff
	grog = log --graph --abbrev-commit --decorate --all --format=format:\"%C(bold blue)%h%C(reset) - %C(bold dim green)%aD%C(dim white) - %an%C(reset) %C(bold dim green)(%ar)%C(reset)%C(bold dim yellow)%d%C(reset)%n %C(white)%s%C(reset)\"

[user]
	name = User Name
	email = testemail@gmail.com
[gui]
	fontui = -family Arial -size 14 -weight normal -slant roman -underline 0 -overstrike 0
	fontdiff = -family Monaco -size 14 -weight normal -slant roman -underline 0 -overstrike 0
